############################
#.........##....##.........#
#P#######.##.##.##.#######P#
#.#######.##.##.##.#######.#
#............##............#
###.#####.########.#####.###
###.#####.########.#####.###
###.##................##.###
###.##.#####.##.#####.##.###
###.##.#####.##.#####.##.###
###......................###
###.##.##.########.##.##.###
###.##.##.########.##.##.###
#...##.##.########.##.##...#
#.####.##.########.##.####.#
#.####.##.########.##.####.#
#...##.##..........##.##...#
###.##.##.########.##.##.###
###.##.##.########.##.##.###
###......................###
###.#####.########.#####.###
###.#####.########.#####.###
###....##....##....##....###
######.#####.##.#####.######
######.#####.##.#####.######
#......##..........##......#
#.####.##.########.##.####.#
#P####.##.########.##.####P#
#..........................#
############################
############################
