############################
#............##............#
#.####.#####.##.#####.####.#
#P####.#####.##.#####.####P#
#.####.#####.##.#####.####.#
#..........................#
#.####.##.########.##.####.#
#.####.##.########.##.####.#
#......##....##....##......#
######.#####.##.#####.######
######.#####.##.#####.######
##.....##..........##.....##
##.###.##.########.##.###.##
##.###.##.########.##.###.##
##.###................###.##
##.###.##.########.##.###.##
##.###.##.########.##.###.##
##.....##..........##.....##
######.##.########.##.######
######.##.########.##.######
#............##............#
#.####.#####.##.#####.####.#
#.####.#####.##.#####.####.#
#P..##................##..P#
###.##.##.########.##.##.###
###.##.##.########.##.##.###
#......##....##....##......#
#.##########.##.##########.#
#.##########.##.##########.#
#..........................#
############################
