############################
#....##################....#
#.##.##################.##.#
#.##....................##.#
#P#######.########.#######P#
#.#######.########.#######.#
#..........................#
#.####.##.########.##.####.#
#.####.##.########.##.####.#
#......##....##....##......#
#.####.#####.##.#####.####.#
#.####.#####.##.#####.####.#
#...##.##..........##.##...#
###.##.##.########.##.##.###
###.##.##.########.##.##.###
###.......########.......###
###.##.##.########.##.##.###
###.##.##.########.##.##.###
#...##.##.... .....##.##...#
#.####.#####.##.#####.####.#
#.####.#####.##.#####.####.#
#......##....##....##......#
#.####.##.########.##.####.#
#.####.##.########.##.####.#
#..........................#
#.#######.########.#######.#
#P#######.########.#######P#
#.##....................##.#
#.##.##################.##.#
#....##################....#
############################
