############################
#....##################....#
#.##.####..........####.##.#
#.##.####.########.####.##.#
#P##.####.########.####.##P#
#.##.........##.........##.#
#.####.#####.##.#####.####.#
#.####.#####.##.#####.####.#
#..........................#
######.##.########.##.######
######.##.########.##.######
######.##..........##.######
######.##.########.##.######
######.##.########.##.######
###.......########.......###
###.##.##.########.##.##.###
###.##.##.########.##.##.###
###....##..........##....###
######.##.########.##.######
######.##.########.##.######
#..........................#
#.#######.########.#######.#
#.#######.########.#######.#
#P##....................##P#
#.##.###.##########.###.##.#
#.##.###.##########.###.##.#
#....###............###....#
#.##########.##.##########.#
#.##########.##.##########.#
#............##............#
############################
