############################
#.........##....##.........#
#.####.##.##.##.##.##.####.#
#.####.##.##.##.##.##.####.#
#....P.##....##....##.P....#
#.####.#####.##.#####.####.#
#.####.#####.##.#####.####.#
#.##.........##.........##.#
#.##.####.########.####.##.#
#.##.####.########.####.##.#
#..........................#
#.####.##.########.##.####.#
#.####.##.########.##.####.#
#.####.##.########.##.####.#
#......##.########.##......#
#.####.##.########.##.####.#
#.####.##..........##.####.#
#...##.##.########.##.##...#
###.##.##.########.##.##.###
###.##.......##.......##.###
#...##.#####.##.#####.##...#
#.####.#####.##.#####.####.#
#.####.##..........##.####.#
#......##.##.##.##.##......#
#.##.####.##.##.##.####.##.#
#.##.####.##.##.##.####.##.#
#.##.P....##....##....P.##.#
#.#######.########.#######.#
#.#######.########.#######.#
#..........................#
############################
